! Conscious Interactive
! hi
! Test Tile Level 1
! # = Tile Legend 
! 5 = TileDirt
! 8 = GrassTop
! 2 = GrassBot
! 4 = GrassLeft
! 6 = GrassRight 
! 1 = stdGrass
111111111165555566111111111
111111111161115111111111111
111111111111116111111111111
111116111111111111111116111
111161111111111111111161611
111611111111111611111111111
111111111111111111111111111
651111111111111111111111111
555556111111111111111111111
555555555111111111111111111
555555555111111111115151566
555555561111111111155155555
555151151111111111151555555
651111115111111111115155555
111111111111111111111115555
611116111111111111111111655
111116111111111111111111116

