! Conscious Interactive
! hi
! Test Tile Level 1
! # = Tile Legend 
! 5 = TileDirt
! 8 = GrassTop
! 2 = GrassBot
! 4 = GrassLeft
! 6 = GrassRight 
! 1 = stdGrass
1111111111111111111111111
1161111111111111111111111
1616111111111111111111111
1111111111111111111111111
1111111111111111111111111
1556511111111111111111111
5555555561111111111111111
1551555555555111111111111
5555555111111111151515661
5555555555611111555555555
5155551511511111111515555
1556511111151111115155555
1551111111111111115555115
1115611116111111655111111
1111111111111111116111111

